##-------##--------*
##-------##---------
--##--#------#--##--
--##--##----##--##--
--------------------
--------------------
--####----####----##
####----###-----####
-------######-------
-------######------*
####----####----####
#####----##----#####
*-------------------
--------------------
########----########
--#---------#-------
--#---------#-------
--#####-----######--
--------------------
P--------#----------
###----#####----####